DDDDDDDDDD
DDD....DDD
D..DDDD..D
D..DDDD..D
D..DDDD..D
D..DDDD..D
D..DDDD..D
D..DDDD..D
DDD....DDD
DDDDDDDDDD